SO      ./textures/purplestone.xpm  
C 163,208,230
WE ./textures/redbrick......xpm
EA ./textures/wood.xpm
F 255,53,5
NO ./textures/greystone.xpm
















11111111111
111000D00111
11111N11111
1111111111