NO        ./textures/greystone     .xpm
SO ./textures/purplestone.xpm
C 163,208,230
WE 	        ./       textures/redbrick         .xpm
EA ./textures/wood.xpm

F 77,    92       ,53

        1111111111111111111111111               1
        10000000001100D0000000001
        101100020111000000000001
        1001000000000000000002001
 111111111011000001110000000200001
100000000011000001110111110111111
11110111111111011100000010001
11110111111111011101010010001
11000000110101011100000010001
1000000000000001100000010001
100000D0000000001101010010001
1100000111010101111011110N0111
11110111 1110101 101111010001
11111111 1111111 111111111111










