


NO texture/5.png
SO texture/6.png

F     72,50,72
WE texture/10.png
EA texture/9.png      


C     27,0,61

1111111111111111111111111111111
111111111111111111     1111111111
1111111111111111111111111111111
10000000000000000000000000000N1
100000000000000000000000000001
1111111111111111111111111111111



