NO ./images/NO.xpm

SO ./images/SO.xpm
WE ./images/WE.xpm
EA ./images/EA.xpm
F     00,153,15
C     255,255,255


       111111111111111111111111
       100000000000000000000001
       1000000000000001111111111
       10000000r0000001
111111110000000000000001
10000000000000000000000011111
11111111111111110000000000001
10000000000000010200000000001
1000011111N111110000000000001
10000000000000000000000000001
10000000D00000011111100000001
1001111111000001    100000011
10000011 1000001    100000001
11111111 1111111    111111111