NO texture/5.png
SO texture/6.png
WE texture/10.png
EA texture/9.png

F     72, 50, 72
C     14,11,20


       111111111111111111111111
       100000000000000000000001
       1000000000000001111111111
       1000000000000001
111111110000000000000001
10000000000000000000000011111
11111111111111110000000000001
10000000000000010000000000001
1000011111N111110000000000001
10000000000000000000000000001
10000000D00000011111100000001
1001111111000001    100000011
10000011 1000001    100000001
11111111 1111111    111111111