NO texture/5.png
SO texture/6.png
WE texture/10.png
EA texture/9.png

F     72,254, 72
C     41, 0, 61

11111111111
1000000N01
1111111111