NO texture/5.png
SO texture/6.png
WE texture/10.png
EA texture/9.png

F     72, 50, 72
C     41, 0, 61

1111111
111D111111
110000100011
1D0N00D00001   1
1100001000011
111D1111111
1111111
