

NO texture/5.png



SO texture/6.png
WE texture/10.png
EA texture/9.png

F  72,50,72      
C  1,1,1

       111111111111111111111111
       100000000000000000000001
       100000000000001111111111
       1000000000000001
111111110000000000000001               1
10000000000000000000000011111           1
11111111111111110000000000001
10000000000000010000000000001
1000011111011111000N000000001
10000000000000000000000000001
10000000000000011111100000001
1001111111000001   100000011
10000011 1000001    100000001111111 1111111    111111111
11111111111111111111111111111