NO textures/tex10.png
SO textures/tex11.png
WE textures/tex12.png
EA textures/tex4.png

F     120,6,6
C     10,10,10


       111111111111111111111111
       100000000000000000000001
       1000000000000001111111111
       1000000000000001
111111110000000000000001
100000000000000N0100000011111
11111100000000001010000000001
10000000000000010001000000001
10000111111111110000000000001
10000000000000000000000000001
10000000000000011111100000001
1001111111000001    100000011
10000011 1000001    100000001
11111111 1111111    111111111

