NO textures/tex1.png
SO textures/tex1.png
WE textures/tex1.png
EA textures/tex1.png

F     255,182,193
C     229,208,255


       111111111111111111111111
       100000000000000000000001
       1000000000000001111111111
       1000000010000001
111111110000001000000001
100000000000010N0100000011111
11111100000000001010000000001
10000000000000010001000000001
10000111111111110000000000001
10000000000000000000000000001
10000000000000011111100000001
1001111111000001    100000011
10000011 1000001    100000001
11111111 1111111    111111111

