
NO textures/tex1.png
SO textures/tex1.png
WE textures/tex1.png
EA textures/tex1.png

F     255,182,193
C     229,200,255

       1111
       1     1
      1N11111
       1
