NO ./images/NO.xpm

SO ./images/SO.xpm
WE ./images/WE.xpm
EA ./images/EA.xpm
F     00,153,15
C     255,255,255




	11111111111111
	10101000010001
	10111000110001
	11000101010001
	11N01001000001
	11000001000001
	10000101010001
	10100001010001
	10100100010001
	11111111111111
