NO textures/tex1.png
SO textures/tex1.png
WE textures/tex1.png
EA textures/tex1.png

F     00,153,15
C     255,255,255

11111
11111
10101
10001
10N01
11111
